....#....#......
.!..#..#.##.#...
....#..#....#.$.
.###...######...
..#..#......####
....######......
.#.##...#..###..
.#.#...####...#.
.....#....#.#.#.
.####.....#.#...
....#.......####
###.#.###.....@#
.g..#...#...####
