....#...........
..$.#.#####.#...
.#..#.#...###...
.#....#...#...#.
#.#####.....#...
........#...#.g.
..#.##...#.#....
..#...#......#..
#.###.###....#..
....#.#...#..#..
..#.##..#.#.##..
#.@.#.!.#.###..#
########......#.