.........###....
..@..#.##..#....
######...#...g..
............####
.#.#####..###...
.#......###...#.
#######.....###.
..!...####..#...
.#..#.....###...
..##.####.......
.#...#...#..####
.#.###.#.####$..
.......#......#.